filename,basic_ntokens,basic_ntypes,basic_ncontent_tokens,basic_ncontent_types,basic_nfunction_tokens,basic_nfunction_types,lexical_density_types,lexical_density_tokens,hdd42_aw,mtld_original_aw
W_THA_152.txt,435,158,195,102,240,56,0.6455696202531646,0.4482758620689655,0.7800268502750874,43.025109170305676
W_JPN_164.txt,415,138,197,85,218,53,0.6159420289855072,0.4746987951807229,0.7590954414707746,40.33426966292135
W_JPN_170.txt,427,164,201,97,226,67,0.5914634146341463,0.4707259953161593,0.8082413331662088,45.49602807453776
W_CHN_022.txt,416,177,196,117,220,60,0.6610169491525424,0.47115384615384615,0.8123668389353372,64.38095238095238
W_SIN_010.txt,474,211,200,136,274,75,0.6445497630331753,0.4219409282700422,0.8168536134545975,65.68448098663926
W_JPN_366.txt,407,166,190,110,217,56,0.6626506024096386,0.4668304668304668,0.8183285114515648,53.51682638734121
W_THA_378.txt,417,123,213,79,204,44,0.6422764227642277,0.5107913669064749,0.7510840754164742,38.73019992386353
W_JPN_400.txt,489,146,220,79,269,67,0.541095890410959,0.4498977505112474,0.7828639067974055,43.31351502706739
W_THA_393.txt,487,145,228,93,259,52,0.6413793103448275,0.4681724845995893,0.7744129158320192,47.244177611006876
W_THA_230.txt,423,126,211,77,212,49,0.6111111111111112,0.4988179669030733,0.7620197237568839,39.31445865692097
W_JPN_206.txt,429,115,191,74,238,41,0.6434782608695652,0.44522144522144524,0.7105488929915389,33.57620061967467
W_PHL_069.txt,420,154,178,93,242,61,0.6038961038961039,0.4238095238095238,0.7879419198672525,50.42016929705429
W_KOR_074.txt,396,131,221,87,175,44,0.6641221374045801,0.5580808080808081,0.7778966902975327,35.40515532055519
W_THA_032.txt,458,195,201,118,257,77,0.6051282051282051,0.4388646288209607,0.8507450234965838,70.88095238095238
W_THA_026.txt,536,197,250,134,286,63,0.6802030456852792,0.4664179104477612,0.7725308272925269,43.79108805561782
W_CHN_142.txt,398,162,188,101,210,61,0.6234567901234568,0.4723618090452261,0.8185142276995171,69.12108455226543
W_JPN_004.txt,434,168,200,104,234,64,0.6190476190476191,0.4608294930875576,0.8282833445879761,59.585776023085174
W_CHN_157.txt,425,174,214,122,211,52,0.7011494252873564,0.5035294117647059,0.8085221895896355,58.02543337972922
W_CHN_143.txt,475,177,236,118,239,59,0.6666666666666666,0.4968421052631579,0.7897924963199894,49.78228341656329
W_THA_027.txt,449,149,222,100,227,49,0.6711409395973155,0.49443207126948774,0.7854615912048555,48.936810856658184
W_KOR_075.txt,442,195,207,122,235,73,0.6256410256410256,0.4683257918552036,0.8432350218506991,85.35871559633028
W_SIN_165.txt,482,183,243,131,239,52,0.7158469945355191,0.504149377593361,0.810411888866921,56.58226455486252
W_KOR_115.txt,451,192,233,130,218,62,0.6770833333333334,0.516629711751663,0.8470281231774818,79.69223372781065
W_THA_386.txt,422,142,204,95,218,47,0.6690140845070423,0.4834123222748815,0.7770331791260399,43.135361583826736
W_TWN_111.txt,419,157,193,106,226,51,0.6751592356687898,0.4606205250596659,0.7733252787431618,47.39577406353722
W_JPN_367.txt,408,157,179,97,229,60,0.6178343949044586,0.4387254901960784,0.7848306574793376,47.88629189531078
W_THA_351.txt,456,161,219,106,237,55,0.6583850931677019,0.48026315789473684,0.7750504363018682,48.443469357905514
W_SIN_005.txt,524,218,256,151,268,67,0.6926605504587156,0.48854961832061067,0.8287266047723768,67.8190613421161
W_THA_345.txt,419,186,218,122,201,64,0.6559139784946236,0.5202863961813843,0.81750908986047,53.70117505512624
W_THA_190.txt,428,166,210,104,218,62,0.6265060240963856,0.49065420560747663,0.8072353444427864,57.610365969640895
W_JPN_171.txt,443,178,217,118,226,60,0.6629213483146067,0.4898419864559819,0.8179939228718748,57.39173676201431
W_THA_147.txt,465,179,229,127,236,52,0.7094972067039106,0.4924731182795699,0.7766440613352679,44.38636363636364
W_THA_145.txt,473,168,224,105,249,63,0.625,0.47357293868921774,0.8069495413414884,60.52758569308177
W_JPN_173.txt,431,186,211,122,220,64,0.6559139784946236,0.4895591647331787,0.8196144986593856,56.47082887807869
W_THA_179.txt,405,191,206,126,199,65,0.6596858638743456,0.508641975308642,0.8359946486140762,64.6663497586296
W_JPN_167.txt,430,172,204,108,226,64,0.627906976744186,0.4744186046511628,0.8226535113330274,67.21863621317445
W_CHN_035.txt,468,200,210,137,258,63,0.685,0.44871794871794873,0.8066400975357311,63.86169459523247
W_HKG_061.txt,432,201,207,142,225,59,0.7064676616915423,0.4791666666666667,0.8335242240649848,78.62778473091365
W_THA_353.txt,442,158,185,104,257,54,0.6582278481012658,0.41855203619909503,0.7347393432403965,39.78223765097273
W_JPN_239.txt,436,178,193,107,243,71,0.601123595505618,0.4426605504587156,0.8275216671748099,59.486775656937425
W_KOR_088.txt,459,171,222,114,237,57,0.6666666666666666,0.48366013071895425,0.8050063121492854,54.462535485324
W_TWN_098.txt,469,186,231,122,238,64,0.6559139784946236,0.4925373134328358,0.8002321469620155,53.66329521389903
W_IDN_008.txt,494,199,237,132,257,67,0.6633165829145728,0.4797570850202429,0.8062338712140833,46.82484351034283
W_TWN_067.txt,409,146,195,87,214,59,0.5958904109589042,0.4767726161369193,0.7926064158359679,44.818142839642285
W_KOR_077.txt,541,215,328,158,213,57,0.7348837209302326,0.6062846580406654,0.8242172852831899,64.93577677624603
W_THA_025.txt,435,171,205,113,230,58,0.6608187134502924,0.47126436781609193,0.8141894007434762,57.934205137955495
W_THA_031.txt,431,161,202,105,229,56,0.6521739130434783,0.46867749419953597,0.7990055160726817,41.85673076923077
W_CHN_155.txt,513,206,237,142,276,64,0.6893203883495146,0.4619883040935672,0.809315837759419,56.05025977860684
W_KOR_274.txt,559,179,285,115,274,64,0.6424581005586593,0.5098389982110912,0.8093608619112839,52.91163522012579
W_CHN_140.txt,430,192,222,127,208,65,0.6614583333333334,0.5162790697674419,0.8417057430286641,80.79074889867842
W_KOR_062.txt,479,177,202,109,277,68,0.615819209039548,0.42171189979123175,0.7700720830157708,43.99731089557898
W_SIN_172.txt,538,189,251,135,287,54,0.7142857142857143,0.46654275092936803,0.8042293378808869,61.91096782117416
W_KOR_089.txt,418,173,208,123,210,50,0.7109826589595376,0.49760765550239233,0.7933293564492232,48.915509230807054
W_TWN_106.txt,458,160,200,102,258,58,0.6375,0.4366812227074236,0.777694369759322,50.447269443853116
W_IDN_182.txt,444,189,232,134,212,55,0.708994708994709,0.5225225225225225,0.820256948095028,54.03329809725159
W_JPN_358.txt,451,197,220,128,231,69,0.649746192893401,0.4878048780487805,0.8347605252425618,64.42857142857143
W_CHN_034.txt,411,208,195,145,216,63,0.6971153846153846,0.4744525547445255,0.8442152502813917,79.81574038368842
W_CHN_020.txt,432,181,196,122,236,59,0.6740331491712708,0.4537037037037037,0.8051284119515153,63.04052670344862
W_JPN_172.txt,475,171,232,118,243,53,0.6900584795321637,0.4884210526315789,0.7867358716304473,51.62239735357073
W_CHN_018.txt,378,141,184,92,194,49,0.6524822695035462,0.48677248677248675,0.7752921857308781,36.64756097560975
W_THA_140.txt,413,205,205,138,208,67,0.6731707317073171,0.4963680387409201,0.835276967141335,72.54884873214806
W_THA_183.txt,401,134,198,90,203,44,0.6716417910447762,0.4937655860349127,0.7599056758452994,34.26510329016365
W_JPN_374.txt,569,197,264,119,305,78,0.6040609137055838,0.46397188049209137,0.8316021565666357,56.86156767649925
W_CHN_232.txt,505,222,271,165,234,57,0.7432432432432432,0.5366336633663367,0.8223609513236952,69.12471730395569
W_JPN_348.txt,421,162,216,100,205,62,0.6172839506172839,0.5130641330166271,0.8423380676730512,56.38392857142857
W_SIN_002.txt,495,213,247,161,248,52,0.755868544600939,0.498989898989899,0.8244885341269188,71.74484109974894
W_THA_342.txt,455,220,224,154,231,66,0.7,0.49230769230769234,0.8359805880465314,68.83560120639329
W_TWN_102.txt,407,178,187,110,220,68,0.6179775280898876,0.4594594594594595,0.8374422796970851,76.3125
W_JPN_200.txt,493,198,218,128,275,70,0.6464646464646465,0.4421906693711968,0.8180642283257028,63.266870313801725
W_JPN_214.txt,414,162,180,102,234,60,0.6296296296296297,0.43478260869565216,0.8029938500879584,47.36976439790576
W_THA_222.txt,413,150,192,102,221,48,0.68,0.4648910411622276,0.7921023995647876,50.56103210863675
W_SIN_162.txt,574,251,276,180,298,71,0.7171314741035857,0.4808362369337979,0.8070699194916615,68.5582740213523
W_JPN_228.txt,407,149,198,94,209,55,0.6308724832214765,0.4864864864864865,0.8000622326361276,41.95780090769976
W_JPN_002.txt,365,97,198,67,167,30,0.6907216494845361,0.5424657534246575,0.7230384198156368,33.90521327014218
W_CHN_144.txt,507,182,229,122,278,60,0.6703296703296703,0.4516765285996055,0.7944010227188131,57.65974145891043
W_JPN_016.txt,414,162,210,105,204,57,0.6481481481481481,0.5072463768115942,0.7964402099101241,49.09048470536848
W_THA_034.txt,445,165,219,111,226,54,0.6727272727272727,0.49213483146067416,0.81543048998493,42.33159339830432
W_CHN_187.txt,469,202,227,137,242,65,0.6782178217821783,0.4840085287846482,0.8145245623665491,60.513173137923744
W_KOR_259.txt,481,207,222,131,259,76,0.6328502415458938,0.46153846153846156,0.8320666367344465,69.66410186572244
W_CHN_145.txt,446,153,206,94,240,59,0.6143790849673203,0.4618834080717489,0.774737154224617,48.26973418670357
W_JPN_003.txt,427,153,213,109,214,44,0.7124183006535948,0.49882903981264637,0.7842057922044225,49.767969717064005
W_SIN_163.txt,538,189,259,135,279,54,0.7142857142857143,0.48141263940520446,0.7945053346857471,53.53880482575182
W_THA_237.txt,417,151,188,98,229,53,0.6490066225165563,0.45083932853717024,0.7997624716843786,56.92616486481592
W_THA_223.txt,426,177,203,116,223,61,0.655367231638418,0.4765258215962441,0.8180438161354496,45.46318978006058
W_JPN_215.txt,424,193,201,121,223,72,0.6269430051813472,0.4740566037735849,0.8447159421631207,76.68851735871533
W_CHN_353.txt,454,218,219,148,235,70,0.6788990825688074,0.48237885462555063,0.8482383102073244,88.14502923976607
W_KOR_113.txt,449,179,199,121,250,58,0.6759776536312849,0.44320712694877507,0.7981635878992007,55.009407834248066
W_THA_343.txt,454,165,202,106,252,59,0.6424242424242425,0.44493392070484583,0.7941237245998236,51.45906971333288
W_THA_357.txt,495,162,249,114,246,48,0.7037037037037037,0.503030303030303,0.8115322368848283,57.35946892304001
W_IDN_193.txt,461,197,232,138,229,59,0.700507614213198,0.5032537960954447,0.8283291095174501,57.625
W_HKG_071.txt,477,189,233,120,244,69,0.6349206349206349,0.48846960167714887,0.8117935498779026,61.76789634944117
W_HKG_065.txt,502,219,262,153,240,66,0.6986301369863014,0.5219123505976095,0.8283384729668106,66.14295298472022
W_THA_155.txt,452,191,214,120,238,71,0.6282722513089005,0.47345132743362833,0.8358883589125579,69.12788841290975
W_JPN_163.txt,449,147,206,98,243,49,0.6666666666666666,0.45879732739420936,0.7922970779631647,53.172223100279595
W_THA_169.txt,395,166,164,108,231,58,0.6506024096385542,0.4151898734177215,0.7988675444037631,46.63194444444444
W_JPN_177.txt,424,161,203,101,221,60,0.6273291925465838,0.47877358490566035,0.8088991850646677,51.652542372881356
W_JPN_161.txt,426,166,199,110,227,56,0.6626506024096386,0.4671361502347418,0.8275746148872748,45.27464549596515
W_CHN_027.txt,425,177,204,128,221,49,0.7231638418079096,0.48,0.7889655838007883,49.995001999200326
W_JPN_175.txt,412,176,195,118,217,58,0.6704545454545454,0.4733009708737864,0.8225613471727988,54.07814407814408
W_THA_157.txt,508,195,270,137,238,58,0.7025641025641025,0.531496062992126,0.8205326558809103,53.079605712539546
W_JPN_149.txt,446,194,211,126,235,68,0.6494845360824743,0.4730941704035874,0.8409786265323377,74.33333333333333
W_IDN_191.txt,432,147,199,99,233,48,0.673469387755102,0.46064814814814814,0.7622743769847519,39.27272727272727
W_JPN_363.txt,425,157,212,100,213,57,0.6369426751592356,0.4988235294117647,0.7900546711589089,47.03590530716788
W_SIN_015.txt,446,211,236,149,210,62,0.7061611374407583,0.5291479820627802,0.8513526642046625,92.96363636363637
W_SIN_001.txt,557,212,275,145,282,67,0.6839622641509434,0.49371633752244165,0.7922079756039004,55.868532526475036
W_THA_235.txt,436,174,224,113,212,61,0.6494252873563219,0.5137614678899083,0.80575179735601,49.77733618010839
W_CHN_191.txt,469,193,226,130,243,63,0.6735751295336787,0.48187633262260127,0.8135483166835817,63.89814814814815
W_JPN_014.txt,500,173,230,106,270,67,0.6127167630057804,0.46,0.8030278850856395,56.12742340720741
W_SIN_174.txt,477,228,220,160,257,68,0.7017543859649122,0.4612159329140461,0.8286316977067243,77.98282442748092
W_THA_234.txt,479,191,223,127,256,64,0.6649214659685864,0.46555323590814196,0.8139547055270497,57.14800016561775
W_SIN_148.txt,456,201,200,130,256,71,0.6467661691542289,0.43859649122807015,0.8187729228758039,79.02771378581323
W_JPN_216.txt,474,225,215,146,259,79,0.6488888888888888,0.45358649789029537,0.8521950470230623,88.80000000000001
W_TWN_100.txt,404,177,205,117,199,60,0.6610169491525424,0.5074257425742574,0.8240217393311466,71.96305406591524
W_KOR_138.txt,497,197,227,130,270,67,0.6598984771573604,0.4567404426559356,0.8244693043185819,48.7432819579494
W_THA_383.txt,515,137,269,90,246,47,0.656934306569343,0.5223300970873787,0.7841909098633424,44.204311345844104
W_THA_340.txt,425,163,193,106,232,57,0.6503067484662577,0.4541176470588235,0.7995880881878168,46.275505658023704
W_JPN_376.txt,447,195,226,139,221,56,0.7128205128205128,0.5055928411633109,0.8342566318533858,70.9341211747958
W_THA_368.txt,441,191,193,130,248,61,0.680628272251309,0.4376417233560091,0.8037829897551061,57.37258583690987
W_THA_195.txt,428,197,214,134,214,63,0.6802030456852792,0.5,0.831271447614208,63.73989950446904
W_THA_156.txt,417,147,206,95,211,52,0.6462585034013606,0.4940047961630695,0.7880363058212564,48.369130945690486
W_CHN_026.txt,434,143,215,92,219,51,0.6433566433566433,0.49539170506912444,0.7603418659649622,39.03659476117103
W_THA_131.txt,423,158,186,109,237,49,0.689873417721519,0.4397163120567376,0.8063773624154758,59.19634117921231
W_CHN_041.txt,431,172,215,108,216,64,0.627906976744186,0.4988399071925754,0.8137610197214029,55.8712306125894
W_JPN_113.txt,512,207,210,123,302,84,0.5942028985507246,0.41015625,0.8120857225874363,66.64181413424896
W_HKG_015.txt,445,186,230,129,215,57,0.6935483870967742,0.5168539325842697,0.7951071246779868,50.48953507610854
W_CHN_082.txt,411,181,209,116,202,65,0.6408839779005525,0.5085158150851582,0.8353317615472953,57.94966654650324
W_JPN_339.txt,432,163,223,104,209,59,0.6380368098159509,0.5162037037037037,0.8064146545524438,45.101078616701884
W_JPN_311.txt,403,165,200,108,203,57,0.6545454545454545,0.49627791563275436,0.8036950245141417,46.3185861423221
W_KOR_177.txt,407,162,192,105,215,57,0.6481481481481481,0.47174447174447176,0.8061051716985169,66.89847482543182
W_SIN_098.txt,506,213,230,141,276,72,0.6619718309859155,0.45454545454545453,0.7959197568606039,56.01852864324462
W_THA_253.txt,436,215,238,157,198,58,0.7302325581395349,0.5458715596330275,0.8450035713382282,73.81792305286206
W_SIN_113.txt,521,222,270,164,251,58,0.7387387387387387,0.5182341650671785,0.8297123287810827,72.67758558881519
W_THA_284.txt,441,164,202,111,239,53,0.676829268292683,0.4580498866213152,0.7803539772814774,48.60159521317092
W_KOR_017.txt,409,159,216,108,193,51,0.6792452830188679,0.5281173594132029,0.8216065321192614,52.68149882903981
W_JPN_073.txt,422,169,177,107,245,62,0.6331360946745562,0.4194312796208531,0.8027221561936012,60.94424741098028
W_JPN_067.txt,443,134,188,78,255,56,0.582089552238806,0.42437923250564336,0.7643384161781842,45.63944689307039
W_JPN_098.txt,406,157,175,105,231,52,0.6687898089171974,0.43103448275862066,0.7906359960371181,39.90150730793623
W_KOR_215.txt,423,140,190,80,233,60,0.5714285714285714,0.4491725768321513,0.7686757490707181,34.41706049149339
W_KOR_228.txt,471,170,216,111,255,59,0.6529411764705882,0.4585987261146497,0.7925673912474213,46.9205523066061
W_JPN_099.txt,404,162,191,100,213,62,0.6172839506172839,0.47277227722772275,0.8196161877592198,62.97236614853195
W_THA_044.txt,459,172,233,112,226,60,0.6511627906976745,0.5076252723311547,0.8017585800565239,51.508094645080945
W_THA_050.txt,408,181,186,114,222,67,0.6298342541436464,0.45588235294117646,0.8292903724036689,63.8468067351454
W_THA_291.txt,444,219,224,152,220,67,0.6940639269406392,0.5045045045045045,0.8438177271620931,88.90822669104205
W_JPN_264.txt,420,164,192,112,228,52,0.6829268292682927,0.45714285714285713,0.798517989307066,46.73885063178665
W_JPN_270.txt,413,177,182,119,231,58,0.672316384180791,0.4406779661016949,0.7920102379123612,47.43038497737473
W_JPN_304.txt,396,165,177,110,219,55,0.6666666666666666,0.44696969696969696,0.8191493952178389,59.94650320578478
W_CHN_097.txt,514,192,244,125,270,67,0.6510416666666666,0.47470817120622566,0.7934289697026374,60.32106479315284
W_JPN_106.txt,423,175,205,112,218,63,0.64,0.4846335697399527,0.8200317612917065,58.926120622291684
W_THA_124.txt,530,186,248,117,282,69,0.6290322580645161,0.4679245283018868,0.8244472445990675,58.98938187334092
W_JPN_138.txt,421,160,179,104,242,56,0.65,0.4251781472684085,0.7751960212484307,43.59089482181297
W_CHN_095.txt,583,246,250,173,333,73,0.7032520325203252,0.4288164665523156,0.8102136537345174,66.17916074403959
W_THA_330.txt,522,207,277,146,245,61,0.7053140096618358,0.5306513409961686,0.8294037213749641,65.28239821251242
W_SIN_070.txt,446,186,191,121,255,65,0.6505376344086021,0.4282511210762332,0.8251702659901662,75.5632468645322
W_THA_324.txt,426,120,277,92,149,28,0.7666666666666667,0.6502347417840375,0.7196123347659868,28.0340206185567
W_JPN_306.txt,427,172,215,110,212,62,0.6395348837209303,0.5035128805620609,0.836078564248503,57.849957986521275
W_KOR_174.txt,474,190,188,119,286,71,0.6263157894736842,0.39662447257383965,0.8209615023327711,56.939157566302654
W_SIN_104.txt,417,181,180,116,237,65,0.6408839779005525,0.4316546762589928,0.8262231254606502,79.77391304347827
W_THA_250.txt,417,159,196,102,221,57,0.6415094339622641,0.47002398081534774,0.79412476369703,56.045657467532465
W_THA_278.txt,429,153,237,104,192,49,0.6797385620915033,0.5524475524475524,0.7965103564544526,48.109391124870996
W_THA_287.txt,417,133,186,81,231,52,0.6090225563909775,0.4460431654676259,0.7424638640904009,41.7
W_THA_293.txt,438,200,201,129,237,71,0.645,0.4589041095890411,0.8250700820773266,73.0
W_JPN_058.txt,480,183,226,116,254,67,0.6338797814207651,0.4708333333333333,0.8214449202192257,65.39682539682539
W_THA_052.txt,422,157,192,103,230,54,0.6560509554140127,0.4549763033175355,0.7816387697951109,43.97705711519845
W_CHN_122.txt,444,220,202,150,242,70,0.6818181818181818,0.45495495495495497,0.8325412840412667,82.22763157894737
W_JPN_070.txt,433,149,188,88,245,61,0.5906040268456376,0.4341801385681293,0.7942382522300574,45.741941211561475
W_THA_085.txt,400,192,221,138,179,54,0.71875,0.5525,0.8580581130898789,70.94300518134716
W_THA_091.txt,441,163,204,105,237,58,0.6441717791411042,0.46258503401360546,0.8210206481406047,59.5070564516129
W_KOR_217.txt,450,184,238,124,212,60,0.6739130434782609,0.5288888888888889,0.8130743537507861,50.64137205182424
W_THA_090.txt,489,187,240,121,249,66,0.6470588235294118,0.49079754601226994,0.7899392735554222,55.67633888590364
W_THA_053.txt,412,161,206,107,206,54,0.6645962732919255,0.5,0.8036489596171463,48.853332605342544
W_KOR_029.txt,394,153,196,96,198,57,0.6274509803921569,0.49746192893401014,0.7998080944055382,53.67989417989418
W_JPN_298.txt,425,155,193,99,232,56,0.6387096774193548,0.4541176470588235,0.7811091910122842,49.97420431326232
W_SIN_139.txt,516,215,246,159,270,56,0.7395348837209302,0.47674418604651164,0.7884604624189253,58.5453431372549
W_IDN_081.txt,541,247,265,171,276,76,0.6923076923076923,0.4898336414048059,0.8589742049974702,72.7321239022101
W_IDN_095.txt,500,192,270,131,230,61,0.6822916666666666,0.54,0.8332135127524457,57.99026117751218
W_JPN_267.txt,426,164,181,97,245,67,0.5914634146341463,0.42488262910798125,0.8034981691946309,61.18258212375859
W_KOR_149.txt,420,152,227,104,193,48,0.6842105263157895,0.5404761904761904,0.7826065340926145,46.409881168413044
W_JPN_307.txt,402,161,186,99,216,62,0.6149068322981367,0.4626865671641791,0.8225387479985188,45.71837488457987
W_JPN_313.txt,456,188,213,121,243,67,0.6436170212765957,0.46710526315789475,0.8064239659493778,62.12375960605834
W_SIN_059.txt,453,200,220,134,233,66,0.67,0.4856512141280353,0.8448210283510157,81.96992923038039
W_SIN_071.txt,505,205,237,146,268,59,0.7121951219512195,0.4693069306930693,0.7643140246592246,43.1529303721842
W_HKG_003.txt,405,181,191,114,214,67,0.6298342541436464,0.47160493827160493,0.8165410142462168,67.61705202312139
W_JPN_111.txt,479,132,211,81,268,51,0.6136363636363636,0.4405010438413361,0.7483555237804748,36.84615384615385
W_CHN_084.txt,557,291,290,213,267,78,0.7319587628865979,0.5206463195691203,0.8771272594200965,119.80167597765364
W_CHN_090.txt,413,214,205,147,208,67,0.6869158878504673,0.4963680387409201,0.8451753866076995,98.0667670682731
W_JPN_303.txt,416,161,170,100,246,61,0.6211180124223602,0.40865384615384615,0.7588440757619757,46.22222222222222
W_SIN_075.txt,513,193,228,132,285,61,0.6839378238341969,0.4444444444444444,0.8023670393410983,63.295467024064976
W_KOR_171.txt,413,177,210,124,203,53,0.7005649717514124,0.5084745762711864,0.7728818615931217,42.468071823235384
W_KOR_159.txt,423,195,180,121,243,74,0.6205128205128205,0.425531914893617,0.81925111128948,69.15458015267176
W_THA_269.txt,422,162,206,101,216,61,0.6234567901234568,0.4881516587677725,0.7934857438232533,51.45795231874592
W_SIN_101.txt,429,201,206,137,223,64,0.681592039800995,0.4801864801864802,0.8342886396545847,78.71227544910181
W_THA_255.txt,478,194,234,132,244,62,0.6804123711340206,0.4895397489539749,0.8285555159192474,66.3523701666397
W_JPN_288.txt,452,175,222,113,230,62,0.6457142857142857,0.4911504424778761,0.8064964490875968,45.785412406271305
W_JPN_075.txt,499,181,272,119,227,62,0.6574585635359116,0.5450901803607214,0.8204811121689226,53.181191378966275
W_THA_043.txt,456,185,224,121,232,64,0.654054054054054,0.49122807017543857,0.8214202389673345,50.55747126436781
W_JPN_049.txt,444,151,206,97,238,54,0.6423841059602649,0.46396396396396394,0.7788801360644431,52.133458824344586
W_KOR_213.txt,413,184,241,131,172,53,0.7119565217391305,0.5835351089588378,0.8323772403387455,52.42374167645907
W_THA_081.txt,487,172,234,114,253,58,0.6627906976744186,0.4804928131416838,0.7986542019832102,58.380122950819676
W_KOR_206.txt,419,142,205,87,214,55,0.6126760563380281,0.4892601431980907,0.7724040816511272,40.45848623853211
W_KOR_212.txt,437,167,199,109,238,58,0.6526946107784432,0.45537757437070936,0.8037220852068171,51.753825681969396
W_THA_056.txt,474,143,219,89,255,54,0.6223776223776224,0.4620253164556962,0.764983446707331,42.13647945092492
W_THA_042.txt,421,143,192,86,229,57,0.6013986013986014,0.45605700712589076,0.8047263962901099,49.701388888888886
W_CHN_132.txt,409,174,199,119,210,55,0.6839080459770115,0.48655256723716384,0.8116817908583671,59.442038353803056
W_JPN_289.txt,417,188,190,124,227,64,0.6595744680851063,0.4556354916067146,0.8284405034529718,73.40789903358191
W_KOR_004.txt,481,166,224,109,257,57,0.6566265060240963,0.4656964656964657,0.7742005544853492,45.54893457242092
W_SIN_100.txt,582,258,295,191,287,67,0.7403100775193798,0.506872852233677,0.8120168102397595,74.70440972614765
W_SIN_114.txt,431,173,196,121,235,52,0.6994219653179191,0.4547563805104408,0.7809575667306751,50.66037516234164
W_THA_268.txt,412,162,187,111,225,51,0.6851851851851852,0.4538834951456311,0.793866564081783,48.104563736916674
W_TWN_160.txt,405,188,199,122,206,66,0.648936170212766,0.49135802469135803,0.8342049570437295,60.84131017249267
W_SIN_074.txt,511,248,243,170,268,78,0.6854838709677419,0.4755381604696673,0.8357579094820442,76.13434903047091
W_THA_334.txt,430,180,228,131,202,49,0.7277777777777777,0.5302325581395348,0.8105625357075786,60.303473009289405
W_CHN_091.txt,432,185,202,125,230,60,0.6756756756756757,0.4675925925925926,0.8171708121972558,62.25976500476341
W_THA_122.txt,403,146,214,97,189,49,0.6643835616438356,0.5310173697270472,0.7982671092246585,50.50733362521891
W_JPN_128.txt,428,171,197,109,231,62,0.6374269005847953,0.4602803738317757,0.8233733588327269,51.70047301729793
W_JPN_100.txt,422,161,190,104,232,57,0.6459627329192547,0.45023696682464454,0.8154624996840716,52.92952454762948
W_JPN_102.txt,415,170,207,111,208,59,0.6529411764705882,0.4987951807228916,0.8329103571878695,67.53229363579081
W_THA_108.txt,450,196,224,135,226,61,0.6887755102040817,0.49777777777777776,0.836094650488072,60.267857142857146
W_JPN_116.txt,516,184,209,124,307,60,0.6739130434782609,0.4050387596899225,0.7577715402379811,50.51881954747775
W_THA_120.txt,401,169,197,124,204,45,0.7337278106508875,0.4912718204488778,0.8170135723260089,75.63164556962025
W_TWN_189.txt,479,175,239,120,240,55,0.6857142857142857,0.4989561586638831,0.7979152630230666,49.573116310894235
W_JPN_314.txt,405,153,190,101,215,52,0.6601307189542484,0.4691358024691358,0.7792581345374237,50.973789406133854
W_THA_322.txt,410,185,192,126,218,59,0.6810810810810811,0.4682926829268293,0.8338366173782931,71.59384483339974
W_JPN_328.txt,528,173,247,112,281,61,0.6473988439306358,0.4678030303030303,0.7736926585668755,45.29577464788733
W_SIN_062.txt,517,242,262,176,255,66,0.7272727272727273,0.5067698259187621,0.8362239753456884,71.67217784102033
W_TWN_162.txt,433,151,186,88,247,63,0.5827814569536424,0.4295612009237875,0.7804705111060982,52.67896528451502
W_JPN_274.txt,402,164,216,108,186,56,0.6585365853658537,0.5373134328358209,0.8256463816988142,50.872933884297524
W_JPN_260.txt,419,150,195,102,224,48,0.68,0.46539379474940334,0.7856590302226424,46.44863692377822
W_SIN_102.txt,411,186,192,132,219,54,0.7096774193548387,0.46715328467153283,0.8289321946373641,76.83600190991564
W_TWN_016.txt,418,169,200,112,218,57,0.6627218934911243,0.4784688995215311,0.8040095744276746,60.101197164830154
W_THA_281.txt,407,184,204,117,203,67,0.6358695652173914,0.5012285012285013,0.8535596271338024,66.24423076923077
W_THA_054.txt,446,168,218,107,228,61,0.6369047619047619,0.48878923766816146,0.7912880664740615,45.05664653436871
W_THA_040.txt,460,164,217,110,243,54,0.6707317073170732,0.4717391304347826,0.7639536980686301,44.17460317460318
W_KOR_204.txt,499,221,254,159,245,62,0.7194570135746606,0.5090180360721442,0.8216192078125796,56.35977566994271
W_JPN_089.txt,413,141,174,90,239,51,0.6382978723404256,0.4213075060532688,0.7733141301400479,49.45952181208054
W_THA_097.txt,405,149,195,99,210,50,0.6644295302013423,0.48148148148148145,0.7688602572799847,50.61707250234889
W_CHN_131.txt,422,180,218,125,204,55,0.6944444444444444,0.5165876777251185,0.8226939497378702,61.22251146773381
W_THA_280.txt,418,169,231,116,187,53,0.6863905325443787,0.5526315789473685,0.8353873314308561,66.14526720280173
W_KOR_007.txt,576,236,273,161,303,75,0.6822033898305084,0.4739583333333333,0.8249912859740769,66.94990227025806
W_SIN_117.txt,445,209,217,146,228,63,0.6985645933014354,0.48764044943820223,0.8173454189693986,63.57142857142857
W_THA_243.txt,405,163,240,117,165,46,0.7177914110429447,0.5925925925925926,0.8362634975535731,72.04243059193294
W_JPN_261.txt,451,172,208,109,243,63,0.6337209302325582,0.4611973392461197,0.7825890805513344,49.42034822227646
W_TWN_163.txt,412,164,171,97,241,67,0.5914634146341463,0.41504854368932037,0.784272079802089,45.1096578709909
W_TWN_177.txt,457,171,231,115,226,56,0.672514619883041,0.5054704595185996,0.815550107060541,71.20381965596718
W_SIN_088.txt,445,185,226,125,219,60,0.6756756756756757,0.5078651685393258,0.8021329945084501,59.598214285714285
W_THA_337.txt,509,246,301,188,208,58,0.7642276422764228,0.5913555992141454,0.8605136840716919,78.41144849817067
W_SIN_077.txt,437,210,227,157,210,53,0.7476190476190476,0.5194508009153318,0.8245704978451477,62.674055829228244
W_JPN_315.txt,420,168,213,105,207,63,0.625,0.5071428571428571,0.8207951119387352,64.21575319025963
W_JPN_301.txt,430,178,226,121,204,57,0.6797752808988764,0.5255813953488372,0.8404593906016017,55.046931053123004
W_HKG_005.txt,415,155,196,99,219,56,0.6387096774193548,0.472289156626506,0.7922676947901898,52.16464736813574
W_CHN_086.txt,472,186,248,127,224,59,0.6827956989247311,0.5254237288135594,0.7984489120658465,57.657245980278795
W_CHN_092.txt,504,198,251,134,253,64,0.6767676767676768,0.498015873015873,0.8091092546296178,53.51637554585153
W_THA_104.txt,408,186,194,123,214,63,0.6612903225806451,0.47549019607843135,0.8232105073266649,61.39747726606042
W_CHN_048.txt,441,209,250,159,191,50,0.7607655502392344,0.5668934240362812,0.85029304621721,91.68366385851081
W_THA_110.txt,427,152,186,100,241,52,0.6578947368421053,0.43559718969555034,0.7827129909656644,41.70851393188855
W_CHN_060.txt,423,152,221,99,202,53,0.6513157894736842,0.5224586288416075,0.793487340420056,49.657758620689656
W_SIN_046.txt,594,271,283,189,311,82,0.6974169741697417,0.4764309764309764,0.8515515625068653,95.7244573848597
W_SIN_091.txt,542,266,297,201,245,65,0.7556390977443609,0.5479704797047971,0.8427270956484181,84.1187853835968
W_SIN_085.txt,599,212,322,155,277,57,0.7311320754716981,0.5375626043405676,0.8047664281930361,57.805594405594405
W_SIN_126.txt,431,194,192,128,239,66,0.6597938144329897,0.44547563805104406,0.8233544415863276,59.397296206618236
W_JPN_278.txt,434,181,207,116,227,65,0.6408839779005525,0.4769585253456221,0.8074846641329937,59.5705329153605
W_SIN_132.txt,469,218,230,147,239,71,0.6743119266055045,0.4904051172707889,0.8295157174343835,67.20565198983911
W_JPN_250.txt,411,170,198,113,213,57,0.6647058823529411,0.48175182481751827,0.7929114509043456,55.10086049140688
W_JPN_287.txt,430,149,205,89,225,60,0.5973154362416108,0.47674418604651164,0.7957903589447972,50.76239993157991
W_CHN_128.txt,569,228,243,148,326,80,0.6491228070175439,0.4270650263620387,0.8028541833430766,62.57564707172625
W_THA_064.txt,448,151,229,109,219,42,0.7218543046357616,0.5111607142857143,0.7724949960177562,40.19082287575438
W_CHN_100.txt,558,237,265,163,293,74,0.6877637130801688,0.47491039426523296,0.8465309068935872,71.98920982604645
W_JPN_046.txt,384,158,169,91,215,67,0.5759493670886076,0.4401041666666667,0.8191849127176479,53.389859397553074
W_KOR_234.txt,459,163,254,112,205,51,0.6871165644171779,0.5533769063180828,0.7946532895860605,38.792658633757654
W_THA_059.txt,480,164,244,106,236,58,0.6463414634146342,0.5083333333333333,0.8156135849641551,61.9346171070309
W_CHN_101.txt,487,229,250,166,237,63,0.7248908296943232,0.5133470225872689,0.8233831810405385,70.1121391561806
W_THA_065.txt,407,167,203,107,204,60,0.6407185628742516,0.4987714987714988,0.8165879869651751,53.15471404296218
W_THA_298.txt,540,219,215,141,325,78,0.6438356164383562,0.39814814814814814,0.819818779099312,56.10812578276949
W_SIN_127.txt,414,168,199,114,215,54,0.6785714285714286,0.4806763285024155,0.8125587708865323,64.57660521089218
W_TWN_147.txt,517,220,270,148,247,72,0.6727272727272727,0.5222437137330754,0.8552611078646273,79.21910114440755
W_CHN_277.txt,521,189,249,134,272,55,0.708994708994709,0.4779270633397313,0.7884257565753893,56.47298099271305
W_THA_313.txt,433,153,203,104,230,49,0.6797385620915033,0.46882217090069284,0.7932692760778857,48.08863628499256
W_JPN_319.txt,445,163,219,104,226,59,0.6380368098159509,0.49213483146067416,0.8040866904872097,35.34877927254609
W_CHN_061.txt,431,193,210,126,221,67,0.6528497409326425,0.4872389791183295,0.8305253046463906,76.736190042352
W_THA_105.txt,411,149,214,104,197,45,0.697986577181208,0.5206812652068127,0.7859282505621602,42.971416725605444
W_THA_113.txt,455,163,219,114,236,49,0.6993865030674846,0.48131868131868133,0.7675760699249328,45.857951379088234
W_JPN_119.txt,425,164,226,113,199,51,0.6890243902439024,0.5317647058823529,0.7923298489739546,46.161290898396615
W_CHN_063.txt,446,173,205,111,241,62,0.6416184971098265,0.45964125560538116,0.8106838149059475,60.142819399872636
W_CHN_077.txt,456,197,202,132,254,65,0.6700507614213198,0.44298245614035087,0.8139072265514399,71.00449261936255
W_CHN_088.txt,405,190,212,129,193,61,0.6789473684210526,0.5234567901234568,0.8511487687748851,73.56167763157895
W_TWN_192.txt,417,193,213,132,204,61,0.6839378238341969,0.5107913669064749,0.8316484387466447,69.5
W_SIN_079.txt,466,223,225,151,241,72,0.6771300448430493,0.48283261802575106,0.8436402858757877,74.97737765466297
W_TWN_179.txt,410,142,217,94,193,48,0.6619718309859155,0.5292682926829269,0.7676093167281921,46.681592930921255
W_THA_265.txt,419,185,207,132,212,53,0.7135135135135136,0.49403341288782815,0.8025593735380162,51.137405482041586
W_THA_259.txt,416,178,188,113,228,65,0.6348314606741573,0.4519230769230769,0.8240027885812969,61.18412242945959
W_JPN_284.txt,425,183,211,125,214,58,0.6830601092896175,0.4964705882352941,0.8161903027938026,56.22631917785614
W_JPN_290.txt,456,187,218,119,238,68,0.6363636363636364,0.4780701754385965,0.8227503635375755,67.19446949461329
W_KOR_021.txt,397,152,184,105,213,47,0.6907894736842105,0.4634760705289673,0.7955396561733025,54.49193909538737
W_CHN_117.txt,411,178,204,118,207,60,0.6629213483146067,0.49635036496350365,0.8407547615117117,73.8608695652174
W_KOR_237.txt,446,184,218,119,228,65,0.6467391304347826,0.48878923766816146,0.8191330752132256,57.21071552022123
W_JPN_093.txt,418,101,180,59,238,42,0.5841584158415841,0.430622009569378,0.717837358308519,47.480083857442345
W_JPN_044.txt,420,145,184,90,236,55,0.6206896551724138,0.4380952380952381,0.774764457591567,45.56395715185885
W_JPN_291.txt,446,177,208,119,238,58,0.672316384180791,0.4663677130044843,0.8002349826086934,52.130355700299255
W_THA_258.txt,408,131,205,86,203,45,0.6564885496183206,0.5024509803921569,0.7455855415017615,25.892682926829266
W_THA_270.txt,430,171,222,119,208,52,0.695906432748538,0.5162790697674419,0.8246469753980479,68.34876543209877
W_SIN_093.txt,518,186,245,133,273,53,0.7150537634408602,0.47297297297297297,0.7861870749627159,50.45104166666667
W_SIN_087.txt,518,235,263,167,255,68,0.7106382978723405,0.5077220077220077,0.8408084582463189,74.5298547350398
W_THA_338.txt,478,155,235,108,243,47,0.6967741935483871,0.4916317991631799,0.7978558361304977,52.411259890444306
W_KOR_197.txt,411,179,204,124,207,55,0.6927374301675978,0.49635036496350365,0.7943549876024933,51.72949467163253
W_SIN_044.txt,419,209,205,139,214,70,0.6650717703349283,0.4892601431980907,0.833704900197264,79.81711026615969
W_CHN_076.txt,472,214,262,152,210,62,0.7102803738317757,0.5550847457627118,0.8571407214592587,77.77026663019004
W_JPN_124.txt,402,155,190,98,212,57,0.632258064516129,0.472636815920398,0.8096380288921615,56.418927064496685
W_JPN_130.txt,465,147,229,98,236,49,0.6666666666666666,0.4924731182795699,0.770070866413931,40.74663290324728
W_JPN_118.txt,400,145,189,93,211,52,0.6413793103448275,0.4725,0.7908668266363045,48.174294060370016
W_PAK_039.txt,444,214,219,152,225,62,0.7102803738317757,0.49324324324324326,0.8551911803451628,79.20307935254638
W_JPN_134.txt,369,144,165,94,204,50,0.6527777777777778,0.44715447154471544,0.7694915777681254,49.810716575436274
W_CHN_072.txt,422,173,198,117,224,56,0.6763005780346821,0.46919431279620855,0.786220143337688,58.7233685457597
W_JPN_108.txt,559,186,293,126,266,60,0.6774193548387096,0.5241502683363148,0.8004183414801306,44.018370960602034
W_CHN_099.txt,424,180,209,119,215,61,0.6611111111111111,0.49292452830188677,0.8325128361925942,70.66666666666667
W_JPN_322.txt,410,190,217,133,193,57,0.7,0.5292682926829269,0.8424328385348192,76.10071942446044
W_SIN_040.txt,570,226,266,158,304,68,0.6991150442477876,0.4666666666666667,0.830654840210249,71.55687157400156
W_JPN_242.txt,406,149,194,92,212,57,0.6174496644295302,0.47783251231527096,0.8066846980927492,45.111111111111114
W_JPN_256.txt,420,168,212,112,208,56,0.6666666666666666,0.5047619047619047,0.8255786859686216,67.44369529983793
W_THA_260.txt,581,212,266,139,315,73,0.6556603773584906,0.4578313253012048,0.8418587952478476,54.978606978930486
W_JPN_281.txt,458,171,205,105,253,66,0.6140350877192983,0.44759825327510916,0.7863428054953746,45.8
W_KOR_024.txt,410,180,231,125,179,55,0.6944444444444444,0.5634146341463414,0.8349694713637678,56.18465479101176
W_JPN_083.txt,401,151,191,96,210,55,0.6357615894039735,0.4763092269326683,0.8037560566914773,54.633597883597886
W_KOR_227.txt,387,114,204,75,183,39,0.6578947368421053,0.5271317829457365,0.7508066888354575,31.18796606776438
W_JPN_069.txt,407,148,186,95,221,53,0.6418918918918919,0.457002457002457,0.779988141324086,42.91078508889899
W_THA_063.txt,433,173,213,115,220,58,0.6647398843930635,0.49191685912240185,0.824696301610444,74.97424811542024
W_CHN_113.txt,508,181,217,111,291,70,0.6132596685082873,0.4271653543307087,0.7949220417959261,51.915609012275894
W_JPN_041.txt,585,203,274,131,311,72,0.645320197044335,0.4683760683760684,0.7986567065507093,56.26717557251908
W_KOR_031.txt,437,152,194,90,243,62,0.5921052631578947,0.4439359267734554,0.7798243648403461,48.903389923105294
W_SIN_121.txt,448,204,217,147,231,57,0.7205882352941176,0.484375,0.8153974685979188,59.26553264376711
W_THA_275.txt,509,218,216,136,293,82,0.6238532110091743,0.4243614931237721,0.8312926852986685,81.79949363330475
W_THA_249.txt,403,155,188,102,215,53,0.6580645161290323,0.4665012406947891,0.7899471910448959,56.684967850677324
W_JPN_243.txt,440,131,201,81,239,50,0.6183206106870229,0.45681818181818185,0.7774646811194345,48.03775920767564
W_KOR_145.txt,451,220,219,152,232,68,0.6909090909090909,0.48558758314855877,0.834465700650636,76.05098039215687
W_SIN_055.txt,446,210,219,155,227,55,0.7380952380952381,0.4910313901345291,0.8185586028614962,69.29202626270617
W_SIN_041.txt,420,186,203,123,217,63,0.6612903225806451,0.48333333333333334,0.8274446669763147,68.4676007005254
W_SIN_069.txt,450,186,213,129,237,57,0.6935483870967742,0.47333333333333333,0.7981678166217542,59.25906948145112
W_JPN_337.txt,403,171,189,113,214,58,0.6608187134502924,0.46898263027295284,0.8123130728495176,53.973214285714285
W_HKG_027.txt,536,209,248,139,288,70,0.6650717703349283,0.4626865671641791,0.7956117105626501,62.324583866837386
W_THA_103.txt,437,153,197,93,240,60,0.6078431372549019,0.45080091533180777,0.7858577156444095,50.099844993631876
W_JPN_109.txt,436,153,199,91,237,62,0.5947712418300654,0.45642201834862384,0.8003272018110227,43.212280442089465
W_JPN_135.txt,420,156,206,105,214,51,0.6730769230769231,0.49047619047619045,0.7872715867061352,45.56395715185885
W_JPN_123.txt,454,187,225,121,229,66,0.6470588235294118,0.4955947136563877,0.8273945312141086,60.636920314350256
W_JPN_137.txt,409,175,178,109,231,66,0.6228571428571429,0.4352078239608802,0.7962015187416592,66.55592312539383
W_JPN_321.txt,448,180,215,118,233,62,0.6555555555555556,0.4799107142857143,0.8098869761498736,60.445760829322474
W_SIN_057.txt,558,202,266,135,292,67,0.6683168316831684,0.4767025089605735,0.813574537809571,60.96597731821214
W_TWN_180.txt,443,206,196,134,247,72,0.6504854368932039,0.44243792325056436,0.8192824140443673,68.55952380952381
W_JPN_309.txt,438,161,197,96,241,65,0.5962732919254659,0.4497716894977169,0.8114302412518494,49.84957095095673
W_THA_317.txt,426,177,220,125,206,52,0.7062146892655368,0.5164319248826291,0.8004243060781374,53.998493975903614
W_SIN_123.txt,492,230,229,156,263,74,0.6782608695652174,0.4654471544715447,0.8270154953875727,76.15352027854883
W_KOR_033.txt,452,178,234,114,218,64,0.6404494382022472,0.5176991150442478,0.8080778805302606,51.326175040518635
W_TWN_037.txt,422,192,204,128,218,64,0.6666666666666666,0.4834123222748815,0.8404357599051878,70.43830845771144
W_CHN_105.txt,423,162,206,100,217,62,0.6172839506172839,0.48699763593380613,0.8031974114435008,47.28313253012048
W_THA_049.txt,402,130,182,78,220,52,0.6,0.4527363184079602,0.7883553450843551,48.03794441172207
W_JPN_057.txt,420,170,203,119,217,51,0.7,0.48333333333333334,0.800802992014119,60.548794522422696
W_KOR_231.txt,506,194,240,125,266,69,0.6443298969072165,0.4743083003952569,0.8173987002250921,56.89280725367948
W_KOR_219.txt,395,164,212,116,183,48,0.7073170731707317,0.5367088607594936,0.7946416946450613,56.28362185477788
W_CHN_138.txt,443,206,196,136,247,70,0.6601941747572816,0.44243792325056436,0.8201725631873004,71.38395958282149
W_CHN_104.txt,425,193,217,130,208,63,0.6735751295336787,0.5105882352941177,0.8404226453133484,69.5630081300813
W_IDN_059.txt,394,166,191,102,203,64,0.6144578313253012,0.4847715736040609,0.8275558827284007,66.7659463111818
W_THA_289.txt,405,159,209,111,196,48,0.6981132075471698,0.5160493827160494,0.7850761073870798,43.17666126418152
W_SIN_136.txt,630,239,316,166,314,73,0.694560669456067,0.5015873015873016,0.8220736658365083,68.63639215932355
W_THA_276.txt,445,160,192,106,253,54,0.6625,0.4314606741573034,0.7791278212411887,52.53472222222222
W_THA_316.txt,395,142,184,92,211,50,0.647887323943662,0.46582278481012657,0.7700827857280721,53.631553198063656
W_JPN_308.txt,433,163,194,98,239,65,0.6012269938650306,0.44803695150115475,0.8068481536102173,54.125
W_THA_302.txt,528,134,232,87,296,47,0.6492537313432836,0.4393939393939394,0.7238527675460069,33.28059036716546
W_THA_114.txt,431,148,185,88,246,60,0.5945945945945946,0.42923433874709976,0.7512461312655022,39.18181818181818
W_THA_128.txt,407,180,195,125,212,55,0.6944444444444444,0.47911547911547914,0.815007378809124,62.30214969636005
W_CHN_064.txt,468,206,224,140,244,66,0.6796116504854369,0.47863247863247865,0.8129819282242476,63.87900588620013
W_JPN_122.txt,373,176,160,103,213,73,0.5852272727272727,0.4289544235924933,0.8505554463966211,74.93761314113308
W_THA_167.txt,505,229,243,160,262,69,0.6986899563318777,0.48118811881188117,0.8371323484009952,70.88153766963683
W_HKG_094.txt,382,181,199,119,183,62,0.6574585635359116,0.5209424083769634,0.8457321579067862,72.86296296296297
W_JPN_151.txt,453,181,230,118,223,63,0.6519337016574586,0.5077262693156733,0.8266649607235959,54.46489198690022
W_JPN_192.txt,363,151,190,99,173,52,0.6556291390728477,0.5234159779614325,0.8359138571359851,50.2056414922657
W_THA_365.txt,486,119,207,68,279,51,0.5714285714285714,0.42592592592592593,0.7423836361437145,42.11120332720838
W_SIN_151.txt,472,208,226,143,246,65,0.6875,0.4788135593220339,0.827628321878449,70.5338773951264
W_SIN_179.txt,424,184,214,133,210,51,0.7228260869565217,0.5047169811320755,0.8209804771591765,67.4357044051926
W_TWN_045.txt,429,185,220,119,209,66,0.6432432432432432,0.5128205128205128,0.8333181668755595,64.79432785621694
W_SIN_186.txt,497,199,257,141,240,58,0.7085427135678392,0.5171026156941649,0.8169186342009005,57.36757799821487
W_SIN_192.txt,583,248,260,173,323,75,0.6975806451612904,0.44596912521440824,0.8048787036071822,57.45751445086705
W_KOR_041.txt,397,125,204,85,193,40,0.68,0.5138539042821159,0.7387627506339863,34.26739310181904
W_THA_013.txt,429,151,205,103,224,48,0.6821192052980133,0.47785547785547783,0.7993582468347684,52.46484951391193
W_JPN_019.txt,482,151,233,102,249,49,0.6754966887417219,0.483402489626556,0.7838455801100073,52.259815222575725
W_JPN_031.txt,454,189,204,123,250,66,0.6507936507936508,0.44933920704845814,0.8294570079730431,61.92110198538447
W_CHN_177.txt,508,202,241,139,267,63,0.6881188118811881,0.4744094488188976,0.8193174860935131,54.676962685047485
W_KOR_257.txt,472,208,234,146,238,62,0.7019230769230769,0.4957627118644068,0.8423286914051912,74.38874990892089
W_JPN_024.txt,386,157,200,101,186,56,0.643312101910828,0.5181347150259067,0.7989358525960013,49.883711374095995
W_CHN_162.txt,459,187,241,131,218,56,0.7005347593582888,0.5250544662309368,0.8158875311638579,67.6646281018086
W_THA_006.txt,423,191,234,143,189,48,0.7486910994764397,0.5531914893617021,0.8434554217671234,58.404694187994075
W_THA_012.txt,408,194,209,132,199,62,0.6804123711340206,0.5122549019607843,0.8164983761838874,65.97522629823726
W_SIN_193.txt,469,185,219,130,250,55,0.7027027027027027,0.4669509594882729,0.7975160816832202,50.10220166195494
W_SIN_187.txt,580,250,303,176,277,74,0.704,0.5224137931034483,0.8428442336156559,75.93941035300935
W_JPN_226.txt,458,146,220,88,238,58,0.6027397260273972,0.48034934497816595,0.7929215503542214,35.51488833746898
W_SIN_178.txt,464,211,262,157,202,54,0.7440758293838863,0.5646551724137931,0.8388747378664037,68.8155510531748
W_JPN_232.txt,406,162,182,106,224,56,0.654320987654321,0.4482758620689655,0.7870540883104207,51.61834600760456
W_TWN_118.txt,452,214,216,149,236,65,0.6962616822429907,0.4778761061946903,0.8027442104116544,69.47748792960348
W_JPN_391.txt,399,115,182,67,217,48,0.5826086956521739,0.45614035087719296,0.7424411701117704,38.086363636363636
W_JPN_385.txt,402,106,197,67,205,39,0.6320754716981132,0.4900497512437811,0.7180466405779269,29.083118118798424
W_TWN_124.txt,414,168,185,102,229,66,0.6071428571428571,0.4468599033816425,0.8113359190697697,65.76453694960135
W_THA_358.txt,437,146,206,99,231,47,0.678082191780822,0.47139588100686497,0.7632148297983452,45.08194399964835
W_THA_370.txt,412,156,188,106,224,50,0.6794871794871795,0.4563106796116505,0.7860421172395241,53.24538824538824
W_THA_364.txt,405,185,201,127,204,58,0.6864864864864865,0.4962962962962963,0.8206255048237381,64.61607339348592
W_CHN_228.txt,645,269,297,183,348,86,0.6802973977695167,0.4604651162790698,0.8260445251701903,74.28109589142835
W_CHN_016.txt,484,176,218,114,266,62,0.6477272727272727,0.45041322314049587,0.7970348152899592,52.50703633690401
W_THA_172.txt,467,192,238,120,229,72,0.625,0.5096359743040685,0.7955305123530683,42.79935394554684
W_JPN_178.txt,435,152,202,100,233,52,0.6578947368421053,0.46436781609195404,0.7430892966345244,37.04115827461763
W_THA_164.txt,444,154,206,99,238,55,0.6428571428571429,0.46396396396396394,0.7862562488350868,49.630522088353416
W_HKG_097.txt,424,170,220,117,204,53,0.6882352941176471,0.5188679245283019,0.8227738363925771,47.66385880465303
W_JPN_146.txt,478,184,206,118,272,66,0.6413043478260869,0.4309623430962343,0.8014643918421962,65.8357388879777
W_CHN_014.txt,507,221,248,157,259,64,0.7104072398190046,0.4891518737672584,0.8168024019547738,65.95426011252268
W_THA_366.txt,468,171,222,116,246,55,0.6783625730994152,0.47435897435897434,0.8059143640688188,52.40466926070039
W_JPN_344.txt,436,179,213,116,223,63,0.6480446927374302,0.48853211009174313,0.8053669808892336,49.94132334581772
W_JPN_393.txt,465,168,230,113,235,55,0.6726190476190477,0.4946236559139785,0.7805177213437979,49.41396118415169
W_IDN_161.txt,497,195,221,127,276,68,0.6512820512820513,0.44466800804828976,0.8082077101922753,57.13853786810359
W_JPN_387.txt,412,168,189,109,223,59,0.6488095238095238,0.4587378640776699,0.7884333075167462,55.17857142857143
W_JPN_218.txt,425,162,203,98,222,64,0.6049382716049383,0.4776470588235294,0.7896244390398282,43.78060263653484
W_SIN_152.txt,460,213,211,145,249,68,0.6807511737089202,0.45869565217391306,0.8141979365604944,55.98044397463002
W_SIN_191.txt,498,214,260,155,238,59,0.7242990654205608,0.5220883534136547,0.8359055109989177,73.51791262785443
W_SIN_185.txt,564,289,285,209,279,80,0.7231833910034602,0.5053191489361702,0.8623167611305865,99.6963277210659
W_KOR_056.txt,451,162,219,107,232,55,0.6604938271604939,0.48558758314855877,0.7836707960546078,41.935317460317464
W_IDN_001.txt,494,173,250,126,244,47,0.7283236994219653,0.5060728744939271,0.779787898471658,39.77075626798191
W_CHN_174.txt,490,205,237,136,253,69,0.6634146341463415,0.48367346938775513,0.8224241231044235,58.09819897084048
W_JPN_026.txt,441,185,226,128,215,57,0.6918918918918919,0.5124716553287982,0.8180160012990345,53.429980206269285
W_JPN_032.txt,398,153,197,94,201,59,0.6143790849673203,0.4949748743718593,0.8207695177237956,54.46338126175124
W_CHN_160.txt,416,192,213,129,203,63,0.671875,0.5120192307692307,0.8311397290186504,74.6031098273001
W_KOR_240.txt,467,193,218,131,249,62,0.6787564766839378,0.4668094218415418,0.8100798863555515,45.37092011718805
W_KOR_282.txt,586,183,291,120,295,63,0.6557377049180327,0.49658703071672355,0.8148825350679392,62.330961191763926
W_KOR_057.txt,438,135,220,92,218,43,0.6814814814814815,0.502283105022831,0.773701817580373,42.513504853453966
W_SIN_190.txt,535,224,255,157,280,67,0.7008928571428571,0.4766355140186916,0.8086267007182287,67.94525945683802
W_JPN_225.txt,465,195,216,127,249,68,0.6512820512820513,0.4645161290322581,0.8424984079854221,58.25178744546777
W_JPN_386.txt,423,146,184,90,239,56,0.6164383561643836,0.43498817966903075,0.7892234525751441,51.625590737240074
W_JPN_392.txt,422,170,208,110,214,60,0.6470588235294118,0.4928909952606635,0.829191494414146,57.37424572577942
W_JPN_351.txt,366,171,176,111,190,60,0.6491228070175439,0.4808743169398907,0.8358543531852703,67.62423033588908
W_SIN_033.txt,569,232,279,168,290,64,0.7241379310344828,0.4903339191564148,0.795832231469738,55.60302961320718
W_SIN_027.txt,406,213,186,145,220,68,0.6807511737089202,0.458128078817734,0.8298095653112743,83.42270220964666
W_JPN_184.txt,409,149,209,100,200,49,0.6711409395973155,0.511002444987775,0.7958514242238641,48.28472222222222
W_CHN_001.txt,487,201,236,135,251,66,0.6716417910447762,0.48459958932238195,0.8273989731967597,66.92618163494672
W_THA_165.txt,418,173,223,127,195,46,0.7341040462427746,0.5334928229665071,0.7863736073006046,44.12222222222222
W_CHN_029.txt,405,182,192,114,213,68,0.6263736263736264,0.4740740740740741,0.8278240889957281,71.55000000000001
W_THA_171.txt,415,166,200,115,215,51,0.6927710843373494,0.4819277108433735,0.8004215092623043,61.13802179582213
W_THA_149.txt,467,158,204,102,263,56,0.6455696202531646,0.43683083511777304,0.7678206857262204,42.88524374176548
W_HKG_045.txt,381,183,188,127,193,56,0.6939890710382514,0.49343832020997375,0.837010617193615,73.18468934911243
W_JPN_341.txt,437,145,199,89,238,56,0.6137931034482759,0.45537757437070936,0.7844520785940343,43.7
W_THA_377.txt,534,171,270,117,264,54,0.6842105263157895,0.5056179775280899,0.7998846279657762,58.25297402282107
W_SIN_037.txt,482,228,235,161,247,67,0.706140350877193,0.487551867219917,0.8231822418925931,76.2349213691027
W_KOR_127.txt,413,205,207,136,206,69,0.6634146341463415,0.5012106537530266,0.8426261106084686,87.37839412839413
W_JPN_396.txt,390,161,182,109,208,52,0.6770186335403726,0.4666666666666667,0.8110241805096413,65.34778457396216
W_JPN_235.txt,437,174,192,114,245,60,0.6551724137931034,0.43935926773455375,0.8068377182292478,49.969119809315494
W_THA_217.txt,568,215,267,139,301,76,0.6465116279069767,0.47007042253521125,0.8170565656729752,57.107581227436825
W_THA_029.txt,420,176,219,123,201,53,0.6988636363636364,0.5214285714285715,0.8363041372347884,71.50827521598833
W_THA_015.txt,450,193,233,128,217,65,0.6632124352331606,0.5177777777777778,0.8342628545339718,61.615161119915484
W_KOR_245.txt,545,211,280,153,265,58,0.7251184834123223,0.5137614678899083,0.8014680205634325,53.076012979026984
W_KOR_244.txt,498,156,243,104,255,52,0.6666666666666666,0.4879518072289157,0.76680533394814,40.30196304849885
W_CHN_158.txt,431,206,208,144,223,62,0.6990291262135923,0.48259860788863107,0.8343402362838024,74.63658536585366
W_KOR_287.txt,445,184,232,118,213,66,0.6413043478260869,0.5213483146067416,0.8311799019313134,62.28398115646243
W_CHN_164.txt,464,165,214,101,250,64,0.6121212121212121,0.46120689655172414,0.7926995928063624,51.991459561021436
W_KOR_046.txt,418,190,225,137,193,53,0.7210526315789474,0.5382775119617225,0.828783636438096,66.58951707891637
W_TWN_081.txt,496,213,222,143,274,70,0.6713615023474179,0.4475806451612903,0.8320015985936513,74.69742385939568
W_JPN_397.txt,400,190,191,119,209,71,0.6263157894736842,0.4775,0.8360076083215301,83.30755502676978
W_THA_389.txt,449,159,227,105,222,54,0.660377358490566,0.5055679287305123,0.787828148766581,41.099686520376174
W_SIN_036.txt,523,231,240,158,283,73,0.683982683982684,0.4588910133843212,0.8248578649949495,71.09089649438825
W_THA_376.txt,444,159,211,107,233,52,0.6729559748427673,0.4752252252252252,0.8009407921087726,45.489495450785775
W_JPN_181.txt,465,163,203,106,262,57,0.6503067484662577,0.43655913978494626,0.7619109395019018,43.21869466559987
W_JPN_195.txt,422,177,229,121,193,56,0.6836158192090396,0.542654028436019,0.8286587775384877,57.232566155468206
W_THA_160.txt,444,192,209,120,235,72,0.625,0.47072072072072074,0.8349595506342675,72.1006160164271
W_THA_174.txt,412,176,190,113,222,63,0.6420454545454546,0.46116504854368934,0.8243550553138086,63.477196463196776
W_CHN_010.txt,442,207,201,142,241,65,0.6859903381642513,0.45475113122171945,0.8387015595509735,82.1037037037037
W_JPN_142.txt,409,135,195,80,214,55,0.5925925925925926,0.4767726161369193,0.7922163722475246,43.17222222222222
W_THA_148.txt,512,232,270,171,242,61,0.7370689655172413,0.52734375,0.8412966677884347,56.24972869454197
W_CHN_012.txt,470,221,216,146,254,75,0.6606334841628959,0.4595744680851064,0.847866265028645,77.28563438798338
W_JPN_168.txt,562,185,268,123,294,62,0.6648648648648648,0.47686832740213525,0.7865547124209552,50.07007091374099
W_JPN_183.txt,452,187,203,131,249,56,0.7005347593582888,0.4491150442477876,0.7885730337781311,51.355431309904155
W_THA_348.txt,420,159,209,105,211,54,0.660377358490566,0.4976190476190476,0.7949987217165454,55.997000016483426
W_SIN_034.txt,474,208,217,144,257,64,0.6923076923076923,0.4578059071729958,0.8122129856228792,64.00187969924812
W_THA_360.txt,426,148,186,90,240,58,0.6081081081081081,0.43661971830985913,0.7723535150904978,56.50232216000239
W_SIN_020.txt,449,191,200,123,249,68,0.643979057591623,0.44543429844098,0.8300369451932955,85.4826923076923
W_KOR_130.txt,474,197,225,126,249,71,0.6395939086294417,0.47468354430379744,0.8251614263860717,56.916914595729786
W_JPN_381.txt,394,142,200,90,194,52,0.6338028169014085,0.5076142131979695,0.7970739407613764,48.845422064943556
W_IDN_167.txt,500,207,218,133,282,74,0.642512077294686,0.436,0.8193696802158427,61.8192644054713
W_TWN_120.txt,420,214,200,141,220,73,0.6588785046728972,0.47619047619047616,0.8305552711416982,87.76234654583808
W_THA_228.txt,499,161,211,99,288,62,0.6149068322981367,0.4228456913827655,0.7660244538847508,48.74376743188158
W_SIN_168.txt,441,212,231,158,210,54,0.7452830188679245,0.5238095238095238,0.832744355917136,73.6204918032787
W_TWN_097.txt,484,223,233,160,251,63,0.7174887892376681,0.48140495867768596,0.8249263791292568,76.2168284789644
W_TWN_068.txt,440,161,220,96,220,65,0.5962732919254659,0.5,0.8065984462541365,48.90787347033018
W_KOR_078.txt,434,197,197,132,237,65,0.6700507614213198,0.4539170506912442,0.8334352078291828,65.921531239063
W_SIN_183.txt,517,229,240,154,277,75,0.6724890829694323,0.46421663442940037,0.8072815367470529,65.60159329829172
W_KOR_285.txt,464,189,216,125,248,64,0.6613756613756614,0.46551724137931033,0.8157329029345755,57.49391635269235
W_KOR_247.txt,446,211,206,145,240,66,0.6872037914691943,0.4618834080717489,0.8270199924247584,69.62153482082488
W_JPN_009.txt,473,178,228,116,245,62,0.651685393258427,0.4820295983086681,0.8040771410888258,48.7557091882248
W_JPN_021.txt,444,159,228,106,216,53,0.6666666666666666,0.5135135135135135,0.8185361747742594,53.578254847645425
W_SIN_196.txt,454,180,213,116,241,64,0.6444444444444445,0.46916299559471364,0.809957601006235,56.75
W_KOR_079.txt,436,203,226,144,210,59,0.7093596059113301,0.518348623853211,0.8461890627786256,75.42404116516076
W_TWN_041.txt,462,214,212,137,250,77,0.6401869158878505,0.4588744588744589,0.8397411707969392,68.4931645767108
W_THA_201.txt,451,140,251,90,200,50,0.6428571428571429,0.5565410199556541,0.7914654027045736,41.0
W_JPN_223.txt,442,201,219,138,223,63,0.6865671641791045,0.49547511312217196,0.8391298138161707,67.11718325176727
W_SIN_035.txt,524,268,246,189,278,79,0.7052238805970149,0.46946564885496184,0.8529407115000534,87.15335137205481
W_THA_349.txt,500,215,246,154,254,61,0.7162790697674418,0.492,0.8330885974403509,59.31990417692022
W_JPN_357.txt,426,187,181,118,245,69,0.6310160427807486,0.42488262910798125,0.8428763617554341,82.95307982401005
W_JPN_343.txt,437,172,180,105,257,67,0.6104651162790697,0.41189931350114417,0.810857120477723,66.0310999988544
W_THA_177.txt,485,229,261,166,224,63,0.7248908296943232,0.5381443298969072,0.843236969489453,78.92241323491324
W_THA_163.txt,589,197,286,137,303,60,0.6954314720812182,0.4855687606112054,0.782474948549993,37.62489836663242
W_CHN_013.txt,476,208,235,146,241,62,0.7019230769230769,0.49369747899159666,0.821535755499608,74.56729805443472
